11111111111111111111111
10000000000100000000001
10000000000100000000001
10000000000000000000001
10000011000000000000001
10E00010000000001000001
1PC00010000000001000001
11111111111111111111111