111111111111111
100C000C0000001
10C00000C000001
1000000C0000001
100110000000001
100C0000C000001
10C0000C0000001
1000000000000E1
10000000000C001
10000000P000001
1000000C0000001
111111111111111
