11111
10001
10001
10001
100C1
100C1
1C001
10E11
10C01
10001
1P001
10CC1
100C1
10001
11111
