1111111111
1000100E01
10C0100001
1000000001
1P00100C01
1000001001
1000000001
1111111111