111111111111111111
1101E0CC1CC0CC0C11
100010000000000001
1001C00C0000000011
10C000000000C00CC1
10C000000000C000C1
100000000000C100C1
10000000CCP000CC01
10C1CC00000C00C011
110C011C000000C001
100C0C001000001001
1CCC00000001000001
111111111111111111
