11111111111111111111111
1000000C0001000000000E1
10000000000100000000001
10000000000000000000001
10000011000000000000001
1000001000C000001000C01
1P000010000000001000001
11111111111111111111111