9
6
111111111
1000100E1
10C010001
100000011
1P0010001
111111111