9
6
111111111
1000100E1
10C010001
100000001
1P00100C1
111111111