11111111111111111111111
10000000000100000000001
100000000001000E0000001
10C00000000000000000001
100000110000000000C0001
10000010000000001000C01
1P000C10000000001000001
11111111111111111111111